000000000000000000000000000000000000000000000000000000000000000000000000000000000000000000000000000000000000000000000000000000000000000000000000000000000000000000000000000000000000000000000000000200000000000000000000000000200000000200000000000000000000000000000000000000000000000000000000000000100000
000000000000000000000000000000000000000000000000000000000000000000000000000000000000000000000000000000000000000000000000000000000000000000000000000000000000000000000000000000000000000000000000000000000000000000000000000000120000002100000000000000000000000000000000000000000000000000000000000000100000
000000000000000000000000000000000000000000000000000000000000000000000000000000000000000070000000000000000000000000000000000000000000000000000000000000000000000000000000000000000000000000000000000000000000000000000000000000100000000100000000000000000000000000000000000000000000000000000000000000100000
00000000000000000000000000000001111144411110000000000a0000000000000000010000000000000000010000000000000000000000000000000000000000000000000000000000000000000000000000000000000000000000000000020000200002000000000000000000000100000000100000000000000000000000000000000000000000000000000000000000000100000
000000000000000000020000000000000000000000000000000000000000000000010000010000000000000000000000000000000000000000000000000000000000000000000000000000000000000000000000000000000000000000000000000000000000000000001000000000000000000000000000000000000000000000000000000000000000000000000000000000100000
000000000000000000000000111110000000000000000100000000000000010010000000000000000000000000000000000000000000000000000000000000000000000000000000000000000500000000000000000000000000000000000060000000600000070001000000001000000000000000000000000000000000000000000000000000000000000000000000000000100000
000000000000000000000000000000000000000000000000000000000000000000070000000000100000000000000000000000000000000000000000000000000000000000000011101101100111110000000000000000000000000000011111111111111111110000000001000000101000010000000000000000000000000000000000000000000000000000000000000000100000
0000000000000000001111100000000000000000000000000100010001000000000010000000000000000000000000000000000000000000000000000000000000000000000001100000001000010000000000000000000000011001100000020002000002000000000000000000000000111100000000000000000000000000000000000000000000000000000000000000000100000
00000000B0000000000000000000000000000000000000000000000000000000000000000000000000010000000000000000000000000000000000000000000000000000000110022200001000010000000000000000000000011001100000000000000000000000000000000000000000000000000000000000000000115511000000000000000000000000000000000000000100000
000000000000001000000000000000000000000000000000000000000000000000000000000000000000000000000000000000000000000000000000000000000000000011000000000111000010000000000000000000000111551110000000000000000000000000000000000000000000000000000000000000000011110000000000000000000000000000000000000000100000
000000011100010000000000000000000000000000144444444444444444444444444444444444444410000000000000000000000000000000006000000000000000001100000000001001000010000000000000000700000011111100000000000000600000000000000000000000000000000000001100050000500011110000000000000000000000000000000000000000100000
111111111111111111111111111111111111111111111111111111111111111111111111111111111111110000000005000005000000001111111111100000000001111111111111111111000011111111111111111111111111111111111111111111111111111111111111111111111111111111111111111111111111111111111111111111111111111111111111111111111111
111111111111111111111111111111111111111111111111111111111111111111111111111111111111111111111111111111111111111111111111100001100001111111111111111111000011111111111111111111111111111111111111111111111111111111111111111111111111111111111111111111111111111111111111111111111111111111111111111111111111
111111111111111111111111111111111111111111111111111111111111111111111111111111111111111111111111111111111111111111111111144440044441111111111111111111444411111111111111111111111111111111111111111111111111111111111111111111111111111111111111111111111111111111111111111111111111111111111111111111111111