000000000000000000000000000000000000000000000000002000000000000000000000000000000000000000000000000000000000000000000000000000000000000000000000000000000000000000000000000000000000000000000000000000000000000000000000000000000000000000000000000000000000000000000000000000000000000000000000000000000000
000000000000000000000000000000000000000000000000000000000000000000000000000000000000000000000000000000000000000000000000000000000000000000000000000000000000000000000000000000000000000000000000000000000000000000000000000000000000000000000000000000000000000000000000000000000000000000000000000000000000
000000000000000000000000000000000000000000000000000000000000000000000000000000000000000000000000000000000000000000000000000000000000000000000000000000000000000000000000000000000000000000000000000000000000000000000000000000000000000000000000000000000000000000000000000000000000000000000000000000000000
000000000000000000000000000000000000000000000000020200000000000000000000000000000000000000000000000000000000000000000000000000000000000000000000000000000000000000000000000000000000000000000000000000000000000000000000000000000000000000000000000000000000000000000000000000000000000000000000000000010000
0000000000000000312100000000000000000000000000000000000000000000000000000000000100101001000000000000000000000000000000000000000020000000000000000000000000000000000000000000000000000000000000000000000000000000000000000000000000000000000000000000000000000000000000000000000000000000000000000000000010000
000000000000000000000000000000000000000000000000000000000000000000000000000000111121111110000000000000000000000000000000000000000000000000000000000000001000000000000000000000000000000000000000000000000000000000000000000000000000000000000000000000000000000000000000000000030000000000000000000000010000
0000000000000003000000000000000000000000000000002002002000000000000000000000000000000000000000000000000000000000000000000000010000000000000000000000000000000000000000000000000000000000000000000000000000000000000000000000000000000000000000000000000000000000000000000030000000000000000000000000000010000
00000000000000000000000000000000000001111100000000000000000000000000000100000000000000000000000000000000000000111111000010000010010000000000000000000000000000000000000000000001000000000000000000000000000000000000000000000000000000000000010000000000000000000000000000000030000000000000000000000010000
0000033000000001000000000000000000000000000000000000000000000000000000110000011111110000000000000000000000000011120010000000000000000000000000000000000000000000000000000101000100000100000000000000000000100001000000000000000000000000000001100000000000000000000000000300000000000000000B0000000000010000
000000000000011100011000000000000000000000000000000000000000000000001110000000000000110000000000000000000000010000000000100000000000010000000000000000000000000000000000000000000000000000000000000000000110000110000000000000000000000000011110000014114114100000000000000003003000000000000000000000010000
0000000000001111100011110000000001100000000000000500000000050000011111100000000000000000100000000050000500001110000000000000000000000000000000000060000000010000000000050144444444444441000000000050000001110000111000000000500000000060001111110000011111111100000000000000000000000000000000000000000010000
111111111111111111111111111111111111111111111111111111111111111111111111111111111111111111111111111111111111111111111111100000000001111111111111111111000011111111111111111111111111111111111111111111111114444111111111111111111111111111111111111111111111111111111111111111111111111111111111111111111111
111111111111111111111111111111111111111111111111111111111111111111111111111111111111111111111111111111111111111111111111100000000001111111111111111111000011111111111111111111111111111111111111111111111111111111111111111111111111111111111111111111111111111111111111111111111111111111111111111111111111
111111111111111111111111111111111111111111111111111111111111111111111111111111111111111111111111111111111111111111111111100000000001111111111111111111000011111111111111111111111111111111111111111111111111111111111111111111111111111111111111111111111111111111111111111111111111111111111111111111111111
